Martes 1 de Octubre	,,ANGYY PAOLA RIOS; OMAR NAVARRO; LUZ DARY TORRES; YENNY PAOLA VELAZQUES,YULIANA RIVILLAS,ERICSON  ROJAS,,
Miercoles 2 de Octubre	,,LUZ DARY TORRES; OMAR NAVARRO; YENNY PAOLA VELAZQUES; ERICSON  ROJAS,YULIANA RIVILLAS,ANGYY PAOLA RIOS,,
Jueves 3 de Octubre	,,ANGYY PAOLA RIOS; OMAR NAVARRO; YENNY PAOLA VELAZQUES; ERICSON  ROJAS,YULIANA RIVILLAS,LUZ DARY TORRES,,
Viernes 4 de Octubre	,,ANGYY PAOLA RIOS; OMAR NAVARRO; YENNY PAOLA VELAZQUES; LUZ DARY TORRES; ERICSON  ROJAS,,YULIANA RIVILLAS,,
Sabado 5 de Octubre	,YULIANA RIVILLAS; ERICSON  ROJAS,,,,,
Domingo 6 de Octubre	,,,,,YULIANA RIVILLAS; ERICSON  ROJAS,SE LE PAGA EL DOMINICAL  A YULIANA RIVILLAS
Lunes 7 de Octubre	,,YULIANA RIVILLAS; LUZ DARY TORRES; OMAR NAVARRO; ERICSON  ROJAS,YENNY PAOLA VELAZQUES,ANGYY PAOLA RIOS,,
Martes 8 de Octubre	,,YULIANA RIVILLAS; OMAR NAVARRO; ERICSON  ROJAS,ANGYY PAOLA RIOS; YENNY PAOLA VELAZQUES,LUZ DARY TORRES,,
Miercoles 9 de Octubre	,,OMAR NAVARRO; ERICSON  ROJAS; LUZ DARY TORRES,ANGYY PAOLA RIOS; YENNY PAOLA VELAZQUES,YULIANA RIVILLAS,,
Jueves 10 de Octubre	,,YULIANA RIVILLAS; LUZ DARY TORRES; OMAR NAVARRO; ERICSON  ROJAS,ANGYY PAOLA RIOS; YENNY PAOLA VELAZQUES,YENNY PAOLA VELAZQUES,,
Viernes 11 de Octubre	,,YULIANA RIVILLAS; LUZ DARY TORRES; OMAR NAVARRO,ANGYY PAOLA RIOS; YENNY PAOLA VELAZQUES,OMAR NAVARRO,,ERICKZON DESCANSA ESTE DIA POR EL TRABAJO DEL DOMINGO 06 DE OCTUBRE
Sabado 12 de Octubre	,ANGYY PAOLA RIOS; YENNY PAOLA VELAZQUES,,,,,
Domingo 13 de Octubre	,,,,,ANGYY PAOLA RIOS; YENNY PAOLA VELAZQUES,SE LES PAGA DOMINICAL A ANGGY RIOS Y YENNY VELASQUEZ; ANGYY PAOLA RIOS; YENNY PAOLA VELAZQUES; ERICSON  ROJAS; OMAR NAVARRO
Lunes 14 de Octubre	,,ANGYY PAOLA RIOS; YENNY PAOLA VELAZQUES; ERICSON  ROJAS; OMAR NAVARRO,LUZ DARY TORRES,YULIANA RIVILLAS,,SE LES PAGA FESTIVO  A TODOS 
Martes 15 de Octubre	,,YULIANA RIVILLAS; ANGYY PAOLA RIOS; YENNY PAOLA VELAZQUES; ERICSON  ROJAS; OMAR NAVARRO,,LUZ DARY TORRES,,
Miercoles 16 de Octubre	,,ANGYY PAOLA RIOS; YENNY PAOLA VELAZQUES; ERICSON  ROJAS; YULIANA RIVILLAS,LUZ DARY TORRES,OMAR NAVARRO,,
Jueves 17 de Octubre	,,ANGYY PAOLA RIOS; YENNY PAOLA VELAZQUES; OMAR NAVARRO; YULIANA RIVILLAS,LUZ DARY TORRES,ERICSON  ROJAS,,
Viernes 18 de Octubre	,,YENNY PAOLA VELAZQUES; OMAR NAVARRO; YULIANA RIVILLAS; ERICSON  ROJAS,LUZ DARY TORRES,ANGYY PAOLA RIOS,,
Sabado 19 de Octubre	,LUZ DARY TORRES; OMAR NAVARRO,,,,,
Domingo 20 de Octubre	,,,,,LUZ DARY TORRES; OMAR NAVARRO,SE LE PAGA DOMINICAL A LUZ DARY TORRES
Lunes 21 de Octubre	,,ANGYY PAOLA RIOS; LUZ DARY TORRES; YENNY PAOLA VELAZQUES; ERICSON  ROJAS,YULIANA RIVILLAS,OMAR NAVARRO,,
Martes 22 de Octubre	,,ANGYY PAOLA RIOS; OMAR NAVARRO; LUZ DARY TORRES; YENNY PAOLA VELAZQUES,YULIANA RIVILLAS,ERICSON  ROJAS,,
Miercoles 23 de Octubre	,,LUZ DARY TORRES; OMAR NAVARRO; YENNY PAOLA VELAZQUES; ERICSON  ROJAS,YULIANA RIVILLAS,ANGYY PAOLA RIOS,,
Jueves 24 de Octubre	,,ANGYY PAOLA RIOS; OMAR NAVARRO; YENNY PAOLA VELAZQUES; ERICSON  ROJAS,YULIANA RIVILLAS,LUZ DARY TORRES,,
Viernes 25 de Octubre	,,ANGYY PAOLA RIOS; OMAR NAVARRO; YENNY PAOLA VELAZQUES; LUZ DARY TORRES; ERICSON  ROJAS,,YULIANA RIVILLAS,,
Sabado 26 de Octubre	,YULIANA RIVILLAS; ERICSON  ROJAS,,,,,
Domingo 27 de Octubre	,,,,,YULIANA RIVILLAS; ERICSON  ROJAS,SE LE PAGA EL DOMINICAL  A YULIANA RIVILLAS
Lunes 28 de Octubre	,,YULIANA RIVILLAS; LUZ DARY TORRES; OMAR NAVARRO; ERICSON  ROJAS,YENNY PAOLA VELAZQUES,ANGYY PAOLA RIOS,,
Martes 29 de Octubre	,,YULIANA RIVILLAS; OMAR NAVARRO,ANGYY PAOLA RIOS; YENNY PAOLA VELAZQUES,LUZ DARY TORRES,,
Miercoles 30 de Octubre	,,OMAR NAVARRO; ERICSON  ROJAS; LUZ DARY TORRES,ANGYY PAOLA RIOS; YENNY PAOLA VELAZQUES,YULIANA RIVILLAS,,
Jueves 31 de Octubre	,,YULIANA RIVILLAS; LUZ DARY TORRES; OMAR NAVARRO; ERICSON  ROJAS,ANGYY PAOLA RIOS; YENNY PAOLA VELAZQUES,YENNY PAOLA VELAZQUES,,
