Viernes 1 deNoviembre	,,YULIANA RIVILLAS; YENNY PAOLA VELAZQUES,LUZ DARY TORRES; OMAR NAVARRO,ANGYY PAOLA RIOS,,	ERICZON ROJAS DIAZ DESCANSA
Sabado 2de noviembre	,LUZ DARY TORRES; OMAR NAVARRO,,,,,	
Domingo 3de Noviembre	,,,,,LUZ DARY TORRES; OMAR NAVARRO,	
Lunes 4 de Noviembre	,,ANGYY PAOLA RIOS; LUZ DARY TORRES; OMAR NAVARRO; YENNY PAOLA VELAZQUES,ERICSON  ROJAS,YULIANA RIVILLAS,,	
Martes 5 de Noviembre	,YULIANA RIVILLAS,ANGYY PAOLA RIOS; YENNY PAOLA VELAZQUES,,ERICSON  ROJAS,,	LUZ DARY TORRES TOQUICA Y OMAR JULIAN VALDES NAVARRO DESCANSAN
Miercoles 6 de Noviembre	,ERICSON  ROJAS,ANGYY PAOLA RIOS; OMAR NAVARRO; YENNY PAOLA VELAZQUES,YULIANA RIVILLAS,LUZ DARY TORRES,,	
Jueves 7 de Noviembre	,LUZ DARY TORRES,OMAR NAVARRO; YENNY PAOLA VELAZQUES,YULIANA RIVILLAS; ERICSON  ROJAS,ANGYY PAOLA RIOS,,	
Viernes 8 de Noviembre	,ANGYY PAOLA RIOS,LUZ DARY TORRES; OMAR NAVARRO,YULIANA RIVILLAS; ERICSON  ROJAS,YENNY PAOLA VELAZQUES,,	
Sabado 9 de Noviembre	,YULIANA RIVILLAS; ERICSON  ROJAS,,,,,	
Domingo 10 de Noviembre	,,,,,YULIANA RIVILLAS; ERICSON  ROJAS,	
Lunes 11 de Noviembre	,,YULIANA RIVILLAS; ERICSON  ROJAS; YENNY PAOLA VELAZQUES,LUZ DARY TORRES; OMAR NAVARRO,ANGYY PAOLA RIOS,,	
Martes 12 de Noviembre	,ANGYY PAOLA RIOS,YENNY PAOLA VELAZQUES,OMAR NAVARRO,LUZ DARY TORRES,,YULIANA RIVILLAS MALDONADO Y ERICZON ROJAS DIAZ DESCANSAN
Miercoles 13 de Noviembre	,LUZ DARY TORRES,ANGYY PAOLA RIOS; ERICSON  ROJAS; YENNY PAOLA VELAZQUES,OMAR NAVARRO,YULIANA RIVILLAS,,
Jueves 14 de Noviembre	,YULIANA RIVILLAS,ANGYY PAOLA RIOS; ERICSON  ROJAS,LUZ DARY TORRES; OMAR NAVARRO,YENNY PAOLA VELAZQUES,,
Viernes 15 de Noviembre	,YENNY PAOLA VELAZQUES,YULIANA RIVILLAS; ANGYY PAOLA RIOS,LUZ DARY TORRES; OMAR NAVARRO,ERICSON  ROJAS,,
Sabado 16 de Noviembre	,LUZ DARY TORRES; OMAR NAVARRO,,,,,
Domingo 17 de Noviembre	,,,,,LUZ DARY TORRES; OMAR NAVARRO,
Lunes 18 de Noviembre	,,LUZ DARY TORRES; OMAR NAVARRO; ERICSON  ROJAS,ANGYY PAOLA RIOS; YENNY PAOLA VELAZQUES,YULIANA RIVILLAS,,
Martes 19 de Noviembre	,YULIANA RIVILLAS,,ANGYY PAOLA RIOS; YENNY PAOLA VELAZQUES,ERICSON  ROJAS,,LUZ DARY TORRES TOQUICA Y OMAR JULIAN VALDES NAVARRO DESCANSAN
Miercoles 20 de Noviembre	,ERICSON  ROJAS,YULIANA RIVILLAS; OMAR NAVARRO,ANGYY PAOLA RIOS; YENNY PAOLA VELAZQUES,LUZ DARY TORRES,,
Jueves 21 de Noviembre	,LUZ DARY TORRES,YULIANA RIVILLAS; OMAR NAVARRO; ERICSON  ROJAS,YENNY PAOLA VELAZQUES,ANGYY PAOLA RIOS,,
Viernes 22 de Noviembre	,ANGYY PAOLA RIOS,YULIANA RIVILLAS; LUZ DARY TORRES; OMAR NAVARRO; ERICSON  ROJAS,,YENNY PAOLA VELAZQUES,,
Sabado 23 de Noviembre	,ANGYY PAOLA RIOS; YENNY PAOLA VELAZQUES,,,,,
Domingo 24 de Noviembre	,,,,,ANGYY PAOLA RIOS; YENNY PAOLA VELAZQUES,
Lunes 25 de Noviembre	,,ANGYY PAOLA RIOS; LUZ DARY TORRES; OMAR NAVARRO; SANITAGO CAÃ‘ON,ERICSON  ROJAS,ERICSON  ROJAS,,
Martes 26 de Noviembre	,YULIANA RIVILLAS,OMAR NAVARRO,ERICSON  ROJAS,LUZ DARY TORRES,,ANGGY PAOLA RIOS RUBIO Y YENNY PAOLA VELASQUEZ DESCANSAN
Miercoles 27 de Noviembre	,LUZ DARY TORRES,ANGYY PAOLA RIOS; OMAR NAVARRO,YULIANA RIVILLAS; ERICSON  ROJAS,YENNY PAOLA VELAZQUES,,
Jueves 28 de Noviembre	,YENNY PAOLA VELAZQUES,ANGYY PAOLA RIOS; LUZ DARY TORRES; OMAR NAVARRO,YULIANA RIVILLAS,ERICSON  ROJAS,,
Viernes 29 de Noviembre	,ERICSON  ROJAS,LUZ DARY TORRES; OMAR NAVARRO; YENNY PAOLA VELAZQUES,YULIANA RIVILLAS,ANGYY PAOLA RIOS,,
Sabado 30 de Noviembre	,YULIANA RIVILLAS; ERICSON  ROJAS,,,,,
